20 14
75 768
5 5 5 5 5 5 5 5 7 7 7 5 5 5 5 5 5 5 5 5
5 5 5 5 5 5 1 5 7 7 7 5 5 5 5 5 5 5 5 5
5 5 7 7 5 5 1 5 7 7 7 5 5 7 7 7 7 7 5 5
5 3 7 7 7 7 1 5 7 1 7 7 5 7 5 7 5 7 5 5
5 5 7 7 5 5 5 5 1 1 7 5 5 1 7 7 5 7 5 5
5 5 5 5 5 5 5 1 1 1 1 7 5 1 1 7 7 7 7 5
5 5 5 7 7 7 7 7	1 1 1 1 5 1 1 5 5 5 5 5 
5 5 5 5 7 5 5 5 5 5 5 1 5 7 5 5 5 5 5 5 
5 7 7 7 7 5 7 7 7 7 5 5 5 7 7 5 5 5 5 5
5 5 7 7 7 5 7 7 7 7 5 5 7 7 5 5 5 5 5 5
5 7 7 7 5 5 5 5 7 7 7 7 7 7 7 7 7 7 7 5
5 5 5 5 5 5 5 5 7 7 7 7 7 7 7 7 7 7 7 5 
7 7 7 7 7 7 7 7 7 7 7 7 7 7 7 7 7 7 7 5
5 5 5 5 5 5 5 5 5 5 5 5 5 5 5 5 5 5 5 5 