20 8
75 192
6 6 1 6 1 6 1 6 6 6 6 6 6 6 6 6 6 6 6 6 
6 1 1 1 1 1 1 1 1 1 6 6 6 6 6 6 6 6 6 6
6 1 1 1 1 1 1 1 6 1 1 1 1 1 1 1 1 1 1 6
1 1 1 1 1 1 1 1 1 1 6 1 1 1 1 1 1 1 1 6
6 1 1 1 1 1 1 1 6 6 6 1 1 1 6 6 1 1 1 6
1 1 1 1 1 1 1 1 1 6 6 1 1 6 6 6 6 1 1 6
6 6 6 6 6 6 6 6 6 6 6 6 6 6 6 6 6 6 6 6
6 6 6 6 6 6 6 6 6 6 6 6 6 6 6 6 6 6 6 6